EEEEEEEEEE
EEEEEEEEEE
EEEEDEEEEE
EEEEEEEEEE
EEEWWWWWEE
EEEEEEEAEE
EEEEEEEEEE
EEEEEEEEEE
EEEEEEEEEE
EEEEEEEEEE
